11111111111
10P00000C01
1010C000E01
11111111111