11111111
101000E1
1C0P0C01
11111111