111111111111111111
10010C000001110001
10010P10C01C0E1001
100111111000010001
10000010C001111001
111111111111111111